40 14
1 1 1 1 1 1 1 1 1 1 1 1 1 1 1 1 1 1 1 1 1 1 1 1 1 1 1 1 1 1 1 1 18 19 1 1 1 1 1 1
1 1 1 1 1 1 1 1 1 1 1 1 1 1 1 1 18 19 1 1 1 1 1 1 1 1 1 1 1 1 1 1 1 1 1 1 1 1 1 1
1 1 1 1 1 1 17 1 1 1 1 17 1 1 1 1 1 1 1 1 1 1 1 1 1 1 1 1 1 1 1 1 1 1 1 1 1 1 1 1
3 1 18 19 1 1 1 1 1 1 1 1 1 1 1 1 1 3 17 1 1 1 1 1 1 1 1 18 19 1 1 1 1 1 1 1 1 1 1 1
1 1 1 1 1 1 1 1 1 1 1 1 1 8 1 1 1 1 1 1 1 1 1 1 1 1 1 1 1 1 1 1 1 1 1 1 1 1 1 1
1 1 1 1 1 1 1 1 1 1 1 1 8 8 8 1 1 1 1 1 1 1 2 14 14 14 2 1 1 1 1 1 1 1 1 1 1 1 1 1
1 1 1 1 1 1 1 1 1 1 1 1 8 8 8 1 1 1 1 1 1 1 2 2 2 2 2 1 1 1 1 1 1 1 1 1 1 1 1 23
1 1 1 1 1 1 1 1 1 1 1 8 8 8 8 8 1 1 1 1 1 1 1 1 1 1 1 1 1 1 1 1 1 1 1 1 1 1 23 23
1 1 1 1 1 1 1 1 1 1 1 1 1 12 1 1 1 1 1 1 1 1 1 1 1 1 1 1 1 1 18 19 1 1 1 1 1 2 23 23
1 1 1 1 1 18 19 1 1 1 5 11 11 13 1 1 1 1 1 1 1 1 1 1 1 1 1 1 1 1 1 1 1 1 1 1 23 23 23 2
1 1 1 1 1 1 1 1 1 1 1 1 1 7 1 1 1 1 1 1 1 1 1 1 1 1 1 1 1 1 1 1 1 1 1 23 2 23 2 23
1 10 1 1 9 1 1 1 1 1 1 1 1 7 1 9 1 2 14 14 14 14 14 14 14 14 2 10 1 9 1 9 1 10 2 23 2 23 23 23
0 0 0 0 0 14 14 14 14 14 0 0 0 0 0 0 0 2 15 15 15 15 15 15 15 15 2 0 2 2 23 0 0 23 23 2 23 23 23 23
2 2 2 2 2 23 23 23 23 23 2 2 2 2 2 2 2 2 2 2 2 2 2 2 2 2 2 2 2 0 2 23 23 2 23 23 23 23 23 23