34 17
1 1 1 1 1 1 1 1 1 1 1 1 1 1 1 1 1 1 1 1 1 1 1 1 1 1 1 1 1 1 1 1 1 1
1 1 1 1 1 1 1 1 1 1 1 1 1 1 1 1 1 1 1 1 1 1 1 1 1 1 1 1 1 1 1 1 1 1
1 1 1 1 1 1 1 1 1 1 1 1 1 1 1 1 1 1 1 1 1 1 1 1 1 1 1 1 1 1 1 1 1 1
1 3 1 1 1 1 1 1 1 1 1 1 1 1 1 1 1 1 1 1 1 1 1 1 1 1 1 1 1 1 1 1 1 1
1 1 1 1 1 1 1 1 1 1 1 1 1 1 1 1 1 1 1 1 1 1 1 1 1 1 1 1 1 1 1 1 1 1
1 1 1 1 1 1 1 1 1 1 1 1 1 1 8 1 1 1 1 1 1 1 1 1 1 1 1 1 1 1 1 1 1 1
1 1 1 1 1 1 1 1 1 1 10 1 1 8 8 8 1 1 1 1 1 1 1 1 24 1 1 1 1 1 1 1 1 1
1 1 1 1 1 1 1 1 1 1 0 1 8 8 8 8 8 1 1 1 1 1 1 1 1 1 1 1 1 1 1 1 1 1
1 1 1 1 1 1 1 1 1 1 2 1 1 1 7 1 1 1 1 1 1 1 1 1 1 1 1 1 1 1 1 1 1 1
1 1 1 1 1 1 1 1 1 1 2 1 1 1 4 11 11 6 1 1 1 1 1 1 1 1 1 1 1 1 1 1 1 1
1 1 1 1 9 1 1 1 1 1 2 1 5 11 7 1 1 1 1 1 1 1 1 1 1 1 1 1 1 1 1 1 1 1
1 1 10 1 0 1 1 1 1 1 2 1 1 1 7 1 1 23 14 14 14 14 14 14 14 14 14 14 14 14 23 23 20 20
0 0 0 0 2 0 0 0 0 0 2 0 0 0 0 20 23 23 15 15 15 15 15 15 15 15 15 15 15 15 23 16 16 20
2 2 2 2 2 2 2 2 2 2 2 2 2 2 2 20 16 23 23 23 23 23 23 23 23 23 23 23 23 23 23 16 20 20
16 2 2 16 2 2 16 2 2 2 16 2 2 16 16 20 16 16 16 16 16 16 16 16 16 16 16 16 16 16 16 20 20 16
16 16 2 16 16 16 16 2 16 16 16 16 16 16 16 20 20 20 20 20 20 20 20 20 20 20 20 20 20 20 20 20 16 16
16 16 16 16 16 16 16 16 16 16 16 16 16 16 16 16 16 16 16 16 16 16 16 16 16 16 16 16 16 16 16 16 16 16