22 12
1 1 1 1 1 1 1 1 1 1 1 1 1 1 1 1 1 1 1 1 1 1
1 3 1 1 1 1 1 1 1 17 1 1 1 1 1 1 1 1 1 1 1 1
1 1 1 1 1 1 1 1 1 1 1 1 1 1 1 1 1 1 1 1 1 1
1 1 1 18 19 1 1 1 1 1 1 1 1 1 1 1 1 1 1 1 1 1
1 1 1 1 1 1 1 1 1 1 1 1 8 8 8 1 1 1 1 1 1 1
1 1 1 1 1 1 1 1 1 1 1 8 8 8 8 8 1 1 1 1 1 1
1 1 1 1 1 1 1 1 1 1 1 8 8 8 8 8 1 1 1 1 1 1
1 1 1 1 1 1 1 1 1 1 1 1 1 7 1 1 1 1 1 1 1 1
1 1 1 1 1 1 1 9 1 1 1 1 1 7 1 1 1 1 1 1 1 1
1 1 10 1 1 0 0 0 0 1 10 1 1 7 1 9 1 1 1 1 10 1
0 0 0 0 0 0 0 0 0 0 0 0 0 0 0 0 0 0 0 0 0 0
2 2 2 2 2 2 2 2 2 2 2 2 2 2 2 2 2 2 2 2 2 2